44444444444444444444444444444444444444444444444444
44444444444444444444444444444444444444444444444444
44444444444444444444444444444444444444444444444444
44444444444444455555555555555555555555544444444444
44444444444444455555555555555555555555544444444444
44444444444444455544444444444444444555544444444444
44444444444444455544444444444444444555544444444444
44444444444444455544444444444444444555544444444444
44444444444444455555555555555555555555544444444444
44444444444444455555555555555555555555544444444444
44444444444444444444444444444444444444444444444444
44444444444444444444444444444444444444444444444444
44444444444444422222222222222222222224444444444444
44444444444444422222222222222222222224444444444444
44444444444444444444444444444444444444444444444444
44444444444444411111111111111111111144444444444444
44444444444444411111111111111111111144444444444444
44444444444444444444444444444444444444444444444444
44444444444444444444444444444444444444444444444444
44444444444444444444444444444444444444444444444444
44444444444444444444444444444444444444444444444444
44444444444444444444444444444444444444444444444444
44444444444444444444444444444444444444444444444444
22222222222222222222222222222222222222222222222222
22222222222222222222222222222222222222222222222222
44444444444444444444444444444444444444444444444444
44444444444444411111111111111111111144444444444444
44444444444444411111111111111111111144444444444444
44444444444444444444444444444444444444444444444444
44444444444444444444444444444444444444444444444444
44444444444444455555555555555555555555544444444444
44444444444444455555555555555555555555544444444444
44444444444444455544444444444444444555544444444444
44444444444444455544444444444444444555544444444444
44444444444444455544444444444444444555544444444444
44444444444444455555555555555555555555544444444444
44444444444444455555555555555555555555544444444444
44444444444444444444444444444444444444444444444444
44444444444444444444444444444444444444444444444444
44444444444444444444444444444444444444444444444444
44444444444444444444444444444444444444444444444444
44444444444444444444444444444444444444444444444444
22222222222222222222222222222222222222222222222222
22222222222222222222222222222222222222222222222222
44444444444444444444444444444444444444444444444444
44444444444444444444444444444444444444444444444444